NO ./textures/NO.xpm
SO ./textures/SO.xpm
WE ./textures/WE.xpm

F 125,125,0
C 0,0,0

        1111111111111111111111111
        1000000000000000000000001
        1000000000000000111111111
        11100000000N1111
111111110000000000000001
10000000000000000000000011111
11111111111111110000000000001
10000000000000000000000000001
10000111111111110000000000001
10000000000000000000000000001
10000000000000011111100000001
1001111111000001    100000011
10000011 1000001    100000001
11111111 1111111    111111111
